111111
10E001
10P001
10C001
111111
