111111111111
100000000001
1000C0C00001
10000P000001
1000000000E1
111111111111
