111111
100001
101001
100P01
111111
