11111111111111111111111111111111111111111111111111111111
1100000000000E000000000000000000000000000000000111110011
10000101001000001010010000000101011111011111100001111001
10100100101010100010010001000100011111111111100100111001
1P000000C00C00000000000000000010110000000011001100110001
11111111111111111111111111111111111111111111111111111111