1111111111111
1111111111111
1000000000001
1000000001111
1000000000001
10000C0000001
11110000P0001
11000E0000001
1111111111111
1111111111111