1111111
10P0C11
1000011
10001E1
1111111