11111111
11P11111
11E11111
11C11111
11111111