1111111111111
1111111111111
1000000000001
1000000001111
1000000000011
10000C00001C1
11110000P0001
110000E000001
1111111111111
1111111111111